_____BS___
_______B_B
_BS___B_BB
_BB____S_G
_________B
____GB___G
______B_B_
SS_BB_____
B_B__B_S__
___BB_____