________
____B___
G____BS_
_B_B__B_
_B____B_
___BB__B
B_______
_____B__